cb_capafo;Nombre_Total;Somme_Longueur;Proprietaire;Territoire;Hors_Territoire;INDT
2;2;3853.6745;2;1;1;0
6;2;31.529899999999998;2;1;1;0
12;974;167809.84660000002;974;863;111;0
24;799;150285.4193;799;708;91;0
36;458;220434.06699999998;458;385;73;0
48;579;206723.9103;579;499;80;0
60;2;543.3185;2;2;0;0
72;744;405080.2395;744;630;114;0
96;6;3999.7787;6;5;1;0
120;1;1265.1233;1;1;0;0
144;983;554511.3891;983;805;178;0
288;40;17628.5576;40;36;4;0
